W R W W P W
_ _ G _ _ _
_ _ _ _ _ _
_ _ _ _ _ _
W P W W R W