P R _ _ _ P
_ P _ _ P _
G _ R _ _ _
_ _ P P _ _
_ P _ _ P _
P _ _ _ R P