G W W W W
_ _ _ _ R
_ W _ W _
P W P W P
W W W W W